10 10 10 10 10 10 10 10 10 10 10 10 10 10 10 10 10 10 10 10 10 10 10 10 10 10 10 10 10 10 10 10 10 10 10 10 10 10 10 10 10 10 10 10 10 10 10 10 10 10 
10 10 10 10 10 10 10 10 10 10 10 10 10 10 10 10 10 10 10 10 10 10 10 10 10 10 10 10 10 10 10 10 10 10 10 10 10 10 10 10 10 10 10 10 10 10 10 10 10 10 
10 10 10 10 10 10 10 10 10 10 10 10 10 10 10 10 10 10 10 10 10 10 10 10 10 10 10 10 10 10 10 10 10 10 10 10 10 10 10 10 10 10 10 10 10 10 10 10 10 10 
10 10 10 10 10 10 10 10 10 10 10 10 10 10 10 10 10 10 10 10 10 10 10 10 10 10 10 10 10 10 10 10 10 10 10 10 10 10 10 10 10 10 10 10 10 10 10 10 10 10  
10 10 10 10 10 10 10 10 10 10 10 10 10 10 10 10 10 10 10 10 10 10 10 10 10 10 10 10 10 10 10 10 10 10 10 10 10 10 10 10 10 10 10 10 10 10 10 10 10 10 
10 10 10 10 10 10 10 10 10 10 10 10 10 10 10 10 10 10 10 10 10 10 10 10 10 10 10 10 10 10 10 10 10 10 10 10 10 10 10 10 10 10 10 10 10 10 10 10 10 10  
10 10 10 10 10 10 10 10 10 10 10 10 10 10 23 10 10 10 10 10 10 10 10 10 10 10 10 23 10 10 10 10 10 10 10 10 10 10 10 10 10 10 23 10 10 10 10 10 10 10 
10 10 10 10 10 10 18 10 10 10 10 10 10 10 10 10 10 10 21 10 10 10 11 10 10 10 10 10 10 10 10 21 10 10 35 33 33 33 33 33 33 36 17 10 10 10 10 10 10 10 
10 10 10 10 10 10 18 10 10 10 10 10 10 10 10 10 10 10 10 10 10 14 15 15 15 16 10 10 10 10 10 10 10 10 31 26 26 26 26 26 26 30 17 10 10 10 10 10 10 10
10 10 10 10 10 10 18 10 10 10 10 10 10 10 10 10 10 10 10 10 10 17 10 10 10 18 10 10 10 10 10 10 10 10 31 26 26 26 26 26 26 30 17 10 10 10 10 10 10 10 
10 10 10 10 10 10 18 10 10 10 10 10 10 10 10 10 10 10 10 10 10 17 10 10 10 18 11 10 10 10 10 10 10 10 31 26 26 26 26 26 26 30 17 10 10 10 10 10 10 10 
10 10 10 10 10 10 18 10 10 10 10 10 10 10 10 10 10 10 10 10 10 10 10 10 10 21 10 10 10 10 10 10 10 10 31 26 26 26 26 26 26 30 17 10 10 10 10 10 10 10 
10 10 10 10 10 10 18 10 10 10 10 10 10 10 10 10 10 10 10 10 11 10 35 33 36 10 10 10 10 10 10 10 10 10 37 28 28 29 26 27 28 38 17 10 10 10 10 10 10 10 
10 10 10 10 10 10 18 10 10 10 10 10 10 10 10 10 10 10 10 10 10 10 31 26 30 10 10 10 10 10 10 10 10 10 10 10 10 31 26 30 14 15 25 10 10 10 10 10 10 10 
10 10 10 10 10 10 18 10 10 10 10 10 10 10 10 10 10 10 10 10 10 10 31 26 30 10 10 10 10 10 10 10 10 10 10 10 10 31 26 30 17 10 10 10 10 10 10 10 10 10 
10 10 10 10 10 10 24 15 16 10 10 10 10 10 10 10 10 10 10 10 10 10 31 26 30 10 10 10 10 10 10 10 10 10 10 10 10 31 26 30 17 10 10 10 10 10 10 10 10 10 
10 10 10 10 10 10 10 10 18 10 10 10 10 10 10 10 10 10 10 10 10 10 31 26 30 10 10 10 10 10 10 10 10 10 10 10 10 31 26 30 17 10 10 10 10 10 10 10 10 10
10 10 10 10 10 10 10 10 21 10 10 10 10 10 10 10 10 10 10 10 10 10 31 26 30 10 10 10 10 10 10 10 10 10 10 35 33 34 26 30 17 10 10 10 10 10 10 10 10 10 
10 10 10 10 10 10 10 18 10 10 10 10 10 10 10 10 10 10 10 10 10 10 31 26 30 10 10 10 10 10 10 10 10 10 10 31 26 26 26 30 17 10 10 10 10 10 10 10 10 10 
10 10 10 10 10 10 10 18 10 10 10 10 10 10 10 10 10 10 10 10 10 10 31 26 30 10 10 10 10 10 10 10 10 10 10 31 26 27 28 38 17 10 10 10 10 10 10 10 10 10 
10 10 10 10 10 10 10 18 10 10 10 10 10 35 33 33 33 33 33 33 33 33 34 26 10 33 33 33 33 33 33 33 33 33 33 34 26 30 10 10 17 10 10 10 10 10 10 10 10 10 
10 10 10 10 10 10 10 18 10 10 10 10 11 31 26 26 26 26 26 26 26 26 26 26 26 26 26 26 26 26 26 26 26 26 26 26 26 30 10 14 25 10 10 10 10 10 10 10 10 10 
10 10 10 10 10 10 10 18 10 10 10 10 10 37 28 28 28 28 28 28 28 28 29 26 27 28 28 28 28 28 28 28 28 28 28 29 26 30 10 17 10 10 10 10 10 10 10 10 10 10 
10 10 10 10 10 10 10 24 16 10 10 10 10 10 10 10 10 10 10 10 10 10 31 26 30 10 10 10 10 10 10 10 10 10 10 31 26 30 10 17 10 10 10 10 10 10 10 10 10 10 
10 10 10 10 10 10 10 10 18 10 10 10 10 10 10 10 10 10 10 10 10 10 31 26 30 10 10 10 10 10 10 10 10 10 10 31 26 30 11 17 10 10 10 10 10 10 10 10 10 10 
10 10 10 10 10 10 10 10 21 10 10 10 10 10 10 10 10 10 10 10 10 10 31 26 30 10 10 10 10 10 10 10 10 10 10 31 26 30 10 17 10 10 10 10 10 10 10 10 10 10 
10 10 10 10 10 10 10 18 10 10 10 10 10 10 10 10 10 10 10 10 10 10 31 26 30 10 10 10 10 10 10 10 10 10 10 31 26 30 10 17 10 10 10 10 10 10 10 10 10 10 
10 10 10 10 10 10 10 18 10 10 10 10 10 10 10 10 10 10 10 10 10 10 31 26 30 10 10 10 10 10 10 10 10 10 10 31 26 30 10 17 10 10 10 10 10 10 10 10 10 10 
10 10 10 10 10 10 10 18 10 10 10 10 10 10 10 10 10 10 10 10 10 10 31 26 30 10 10 10 10 10 10 10 10 10 10 31 26 30 10 17 10 10 10 10 10 10 10 10 10 10 
10 10 10 10 10 10 10 18 10 10 10 10 10 10 10 10 10 10 10 10 10 10 31 26 30 10 10 10 10 10 10 10 10 10 10 37 28 38 10 17 10 10 10 10 10 10 10 10 10 10 
10 10 10 10 10 10 10 18 10 10 11 10 10 10 10 10 10 10 10 10 10 10 31 26 30 10 10 10 10 10 10 10 10 10 10 10 10 10 14 25 10 10 10 10 10 10 10 10 10 10 
10 10 10 10 10 10 10 24 16 10 10 10 10 10 10 10 10 10 10 10 10 10 31 26 30 10 10 10 10 10 10 10 10 10 10 10 10 10 17 10 10 10 10 10 10 10 10 10 10 10 
10 10 10 10 10 10 10 10 18 10 10 10 10 11 10 10 10 10 10 10 10 10 31 26 30 10 10 10 10 10 10 10 10 10 10 10 10 10 17 10 10 10 10 10 10 10 10 10 10 10 
10 10 10 10 10 10 10 10 18 11 10 10 10 10 10 10 10 10 10 10 10 10 31 26 30 10 10 10 10 10 10 10 10 10 10 10 10 11 17 10 10 10 10 10 10 10 10 10 10 10 
10 10 10 10 10 10 10 10 18 10 10 10 10 10 10 10 10 10 10 10 10 10 31 26 30 10 10 10 10 10 10 10 10 10 10 10 10 10 17 10 10 10 10 10 10 10 10 10 10 10 
10 10 10 10 10 10 10 10 21 10 10 10 10 10 10 10 10 10 10 10 10 10 37 28 38 10 10 10 10 10 10 10 10 10 10 11 10 10 10 23 10 10 10 10 10 10 10 10 10 10 
10 10 10 10 10 10 10 18 10 10 10 10 10 10 10 10 10 10 10 10 10 10 10 10 10 10 10 10 10 10 10 10 10 10 10 10 10 10 10 10 23 10 10 10 10 10 10 10 10 10 
10 10 10 10 10 10 10 18 10 10 10 10 10 10 10 10 10 10 10 10 10 10 10 10 10 10 10 10 10 10 10 10 10 10 10 10 10 10 10 10 17 10 10 10 10 10 10 10 10 10 
10 10 10 10 10 10 10 18 10 10 10 10 10 10 10 10 10 10 10 11 10 10 10 10 10 11 10 10 10 10 10 10 10 10 10 10 10 11 10 10 17 10 10 10 10 10 10 10 10 10 
10 10 10 10 10 10 10 18 10 10 10 10 10 10 10 10 10 10 10 10 11 10 10 10 10 10 10 10 10 10 10 10 10 10 10 10 10 10 10 10 17 10 10 10 10 10 10 10 10 10 
10 10 10 10 10 10 10 18 10 10 10 10 10 10 10 10 10 10 10 10 10 10 10 10 10 10 10 10 10 10 10 10 10 10 10 10 10 10 10 10 17 10 10 10 10 10 10 10 10 10 
10 10 10 10 10 10 10 18 10 10 10 10 10 10 10 14 15 15 16 10 10 10 10 10 11 10 10 14 15 15 16 10 10 10 10 10 10 10 11 10 17 10 10 10 10 10 10 10 10 10 
10 10 10 10 10 10 10 18 10 10 10 10 10 10 14 25 10 10 24 16 10 10 10 10 10 10 14 25 10 10 18 10 10 10 10 10 10 10 10 10 17 10 10 10 10 10 10 10 10 10 
10 10 10 10 10 10 10 24 15 15 15 15 15 15 25 10 10 10 10 24 15 15 15 15 15 15 25 10 10 10 24 16 10 11 10 10 10 10 14 15 25 10 10 10 10 10 10 10 10 10 
10 10 10 10 10 10 10 10 10 10 10 10 10 10 10 10 10 10 10 10 10 10 10 10 10 10 10 10 10 10 10 24 15 15 15 15 15 15 25 10 10 10 10 10 10 10 10 10 10 10 
10 10 10 10 10 10 10 10 10 10 10 10 10 10 10 10 10 10 10 10 10 10 10 10 10 10 10 10 10 10 10 10 10 10 10 10 10 10 10 10 10 10 10 10 10 10 10 10 10 10 
10 10 10 10 10 10 10 10 10 10 10 10 10 10 10 10 10 10 10 10 10 10 10 10 10 10 10 10 10 10 10 10 10 10 10 10 10 10 10 10 10 10 10 10 10 10 10 10 10 10 
10 10 10 10 10 10 10 10 10 10 10 10 10 10 10 10 10 10 10 10 10 10 10 10 10 10 10 10 10 10 10 10 10 10 10 10 10 10 10 10 10 10 10 10 10 10 10 10 10 10 
10 10 10 10 10 10 10 10 10 10 10 10 10 10 10 10 10 10 10 10 10 10 10 10 10 10 10 10 10 10 10 10 10 10 10 10 10 10 10 10 10 10 10 10 10 10 10 10 10 10 
10 10 10 10 10 10 10 10 10 10 10 10 10 10 10 10 10 10 10 10 10 10 10 10 10 10 10 10 10 10 10 10 10 10 10 10 10 10 10 10 10 10 10 10 10 10 10 10 10 10 