12 12 12 12 12 12 12 12 12 12 12 12 12 12 12 12 12 12 12 12 12 12 12 12 12 12 12 12 12 12 12 12 12 12 12 12 12 12 12 12 12 12 12 12 12 12 12 12 12 12 
12 12 12 12 12 12 12 12 12 12 12 12 12 12 13 12 12 12 12 12 12 12 12 12 12 12 12 12 12 12 12 12 12 12 12 12 12 12 12 12 12 12 12 12 12 12 12 12 12 12 
12 12 12 12 12 12 12 13 12 12 12 12 12 12 12 12 12 12 12 12 12 12 12 12 12 13 12 12 12 12 12 12 12 13 12 12 12 12 12 12 12 12 12 12 12 12 12 12 12 12 
12 12 12 12 13 12 12 12 12 12 12 13 12 12 12 12 12 12 13 12 12 12 12 12 12 12 12 13 12 12 12 12 12 12 12 12 12 12 12 12 12 13 12 12 12 12 12 12 12 12  
12 12 12 12 12 12 12 12 12 13 12 12 12 12 12 13 12 12 12 12 12 12 12 13 12 12 12 12 12 12 12 13 12 12 13 12 12 12 13 12 12 12 12 12 12 12 12 12 12 12 
12 12 12 12 12 12 12 12 12 12 12 12 12 12 12 12 12 12 12 12 12 13 12 12 12 12 12 12 12 13 12 12 12 12 12 12 13 12 12 12 12 12 12 13 12 12 12 12 12 12  
12 12 12 12 12 12 12 13 22 20 20 20 20 20 20 20 23 12 22 20 20 20 20 20 20 20 20 23 12 12 12 22 20 20 20 20 20 20 20 20 20 20 23 12 12 12 12 12 12 12 
12 12 12 12 12 12 12 12 18 39 46 46 46 46 46 39 19 20 21 39 10 10 11 10 10 10 10 19 20 20 20 21 39 10 35 33 33 33 33 33 33 36 17 12 12 13 12 12 12 12
12 12 13 12 12 12 12 12 18 39 46 39 39 39 46 39 39 39 39 39 10 14 15 15 15 16 10 39 39 39 39 39 39 39 31 39 39 39 39 39 39 30 17 12 12 12 12 12 12 12
12 12 12 12 12 12 12 12 18 39 46 39 39 39 46 39 39 39 39 39 10 17 12 12 12 18 10 39 39 39 39 39 39 39 31 39 39 39 39 39 39 30 17 12 12 12 12 12 12 12
12 12 12 13 12 12 12 12 18 39 46 39 39 39 46 39 39 39 39 39 10 17 12 12 12 18 11 39 39 39 39 39 39 39 31 39 39 39 39 39 39 30 17 12 13 12 12 12 12 12
12 12 12 12 13 12 12 12 18 39 46 39 39 39 46 39 39 39 39 39 10 19 20 20 20 21 10 39 39 39 39 39 39 39 31 39 39 39 39 39 39 30 17 12 12 12 12 12 12 12
12 12 12 12 12 12 12 12 18 39 46 46 39 46 46 39 39 39 39 39 11 10 35 33 36 10 10 10 10 10 10 10 10 10 37 28 28 29 26 27 28 38 17 13 12 12 12 12 12 12
12 12 12 12 12 12 12 12 18 39 39 39 10 39 39 39 39 39 39 39 39 39 31 26 30 39 39 39 39 39 39 39 39 39 39 39 39 31 26 30 14 15 25 12 12 12 12 12 12 12 
12 12 12 12 13 12 12 12 24 16 39 39 10 39 39 39 39 39 39 39 39 39 31 26 30 39 39 39 39 39 39 39 39 39 39 39 39 31 26 30 17 12 12 12 12 13 12 12 12 12 
12 12 12 12 12 12 12 12 12 18 39 39 10 39 39 39 39 39 39 39 39 39 31 26 30 39 39 39 39 39 39 39 39 39 39 39 39 31 26 30 17 12 12 12 12 12 12 12 12 12 
12 12 12 12 12 12 12 12 22 21 39 39 10 39 39 39 39 39 39 39 39 39 31 26 30 10 10 10 39 39 39 39 39 39 39 39 39 31 26 30 17 12 12 12 12 12 13 12 12 12 
12 12 13 12 12 12 12 22 21 39 39 39 10 39 39 39 39 39 39 39 39 39 31 26 30 39 39 39 39 39 39 39 39 39 39 35 33 34 26 30 17 12 12 13 12 12 12 12 12 12 
12 12 12 12 12 12 12 18 39 39 10 10 10 39 39 39 39 39 39 39 39 39 31 26 30 39 39 39 39 39 39 39 39 39 39 31 26 26 26 30 17 12 12 12 12 12 12 12 12 12 
12 12 12 13 12 12 12 18 39 39 10 39 39 39 39 39 39 39 39 39 39 10 31 26 30 10 39 39 39 39 39 39 39 39 39 31 26 27 28 38 17 12 13 12 12 12 12 12 12 12 
12 12 12 12 12 12 12 18 39 39 10 39 39 10 35 33 33 33 33 33 33 33 34 26 32 33 33 33 33 36 39 39 39 35 33 34 26 30 10 39 17 12 12 12 12 12 12 12 12 12 
12 12 12 12 12 13 12 18 39 39 10 39 39 11 31 26 26 26 26 26 26 26 26 26 26 26 26 26 26 30 10 10 10 31 26 26 26 30 10 14 25 12 12 12 12 12 12 12 12 12 
12 12 12 12 12 12 13 18 39 39 10 39 39 10 37 28 28 28 28 28 28 28 29 26 27 28 28 28 28 38 39 39 39 37 28 29 26 30 10 17 12 13 12 12 12 12 12 12 12 12 
12 12 12 12 12 12 12 24 16 39 10 39 39 10 39 39 39 39 39 39 39 10 31 26 30 10 39 39 39 39 39 39 39 39 39 31 26 30 10 17 12 12 12 12 13 12 12 12 12 12 
12 12 12 12 12 12 12 12 18 39 10 39 39 10 39 39 39 39 39 39 39 39 31 26 30 39 39 39 39 39 39 39 39 39 39 31 26 30 11 17 12 12 12 12 12 12 12 12 12 12 
12 12 12 12 12 13 12 22 21 39 10 39 39 10 10 39 39 39 39 39 39 39 31 26 30 39 39 39 39 39 39 39 39 39 39 31 26 30 10 17 12 12 12 13 12 12 12 12 12 12 
12 12 12 12 12 12 12 18 39 39 10 39 39 39 10 39 39 39 39 39 39 39 31 26 30 39 39 39 39 39 39 39 39 39 39 31 26 30 10 17 12 12 12 12 12 12 12 12 12 12 
12 12 12 13 12 12 12 18 39 39 10 39 39 39 10 39 39 39 39 39 39 39 31 26 30 39 39 10 39 39 39 39 39 39 39 31 26 30 10 17 12 13 12 12 12 12 12 12 12 12 
12 12 12 12 12 12 12 18 39 39 10 39 39 39 10 39 39 39 39 39 39 39 31 26 30 39 39 39 39 39 10 39 39 39 39 31 26 30 10 17 12 12 12 12 12 12 12 12 12 12 
12 12 12 12 12 12 13 18 39 39 10 10 10 10 10 10 39 39 39 39 39 39 31 26 30 39 39 39 39 39 10 39 39 39 39 37 28 38 10 17 12 12 12 12 13 12 12 12 12 12 
12 12 12 12 12 12 12 18 39 39 11 10 10 10 10 10 39 39 39 39 39 39 31 26 30 39 39 39 39 39 39 39 39 39 39 39 10 39 14 25 12 12 13 12 12 12 12 12 12 12 
12 12 12 12 12 12 12 24 16 39 10 10 10 10 10 10 39 39 39 39 39 39 31 26 30 39 39 39 39 39 39 39 39 39 39 10 10 10 17 12 12 12 12 12 12 12 12 12 12 12 
12 12 12 12 12 13 12 12 18 39 10 10 10 11 10 10 39 39 39 39 39 39 31 26 30 39 39 39 39 39 39 39 39 39 39 10 10 10 17 12 12 12 12 12 12 12 13 12 12 12 
12 12 12 12 12 12 12 12 18 39 10 10 10 10 10 10 39 39 39 39 39 39 31 26 30 39 39 39 39 39 39 39 39 39 39 10 10 11 17 12 12 13 12 12 12 12 12 12 12 12 
12 12 12 12 12 12 12 12 18 39 10 10 10 10 10 10 39 39 39 39 39 39 31 26 30 39 39 39 39 39 39 39 39 39 39 10 10 10 17 12 12 12 12 12 12 12 12 12 12 12 
12 12 12 12 13 12 12 22 21 39 39 39 39 39 39 39 39 39 39 39 39 39 37 28 38 39 39 39 39 39 39 39 39 39 39 11 10 10 19 23 12 12 12 12 12 12 12 12 12 12 
12 12 12 12 12 12 12 18 39 39 39 39 39 39 39 39 39 39 39 39 10 10 10 10 10 10 10 39 39 39 39 39 39 39 10 10 10 10 10 19 23 12 12 12 13 12 12 12 12 12 
12 12 12 12 12 12 13 18 39 39 39 39 39 39 39 39 39 39 39 10 10 10 10 10 10 10 10 10 39 39 10 39 39 10 10 10 10 10 10 10 17 12 12 12 12 12 12 12 12 12 
12 12 12 12 12 12 12 18 39 39 39 39 39 39 39 39 39 39 39 11 10 10 10 10 10 11 10 10 39 39 39 39 10 10 10 10 10 11 10 10 17 12 13 12 12 12 12 12 12 12 
12 12 12 12 12 12 12 18 39 39 42 39 39 39 39 39 39 39 39 10 11 10 10 10 10 10 10 10 10 39 39 39 10 10 10 10 10 39 10 10 17 12 12 12 12 12 12 12 12 12 
12 12 13 12 12 12 12 18 39 39 10 39 39 10 10 10 10 10 10 10 10 10 10 10 10 10 10 10 10 10 10 10 10 10 39 10 10 10 10 10 17 12 12 12 12 13 12 12 12 12 
12 12 12 12 12 12 12 18 39 39 10 10 10 10 39 14 15 15 16 10 10 10 10 10 11 10 10 14 15 15 16 10 10 10 10 10 10 10 11 10 17 12 12 12 12 12 12 13 12 12 
12 12 12 12 12 12 12 18 39 39 39 39 39 39 14 25 12 12 24 16 10 10 10 10 10 10 14 25 12 12 18 10 10 39 10 10 39 10 10 10 17 12 12 12 12 12 12 12 12 12
12 12 12 12 13 12 12 24 15 15 15 15 15 15 25 12 12 12 12 24 15 15 15 15 15 15 25 12 13 12 24 16 10 11 10 10 10 10 14 15 25 12 13 12 12 12 12 12 12 12 
12 12 12 12 12 12 12 12 12 12 12 12 12 12 12 12 12 12 13 12 12 12 12 12 12 12 12 12 12 12 12 24 15 15 15 15 15 15 25 12 12 12 12 12 12 12 13 12 12 12 
12 12 12 12 12 12 12 12 12 12 12 13 12 12 12 12 13 12 12 12 12 12 12 12 12 12 12 12 12 12 12 12 12 12 12 12 13 12 12 12 12 12 12 13 12 12 12 12 12 12 
12 12 12 12 12 12 13 12 12 12 12 12 12 12 12 12 12 12 12 12 12 12 12 12 13 12 12 12 12 13 12 12 12 12 12 12 12 12 12 12 12 12 12 12 12 12 12 12 12 12 
12 12 12 12 12 12 12 12 12 12 12 12 12 12 13 12 12 12 12 12 13 12 12 12 12 12 12 12 12 12 12 12 13 12 12 12 12 12 12 13 12 12 12 12 12 12 12 12 12 12 
12 12 12 12 12 12 12 12 12 12 12 12 12 12 12 12 12 12 12 12 12 12 12 12 12 12 12 13 12 12 12 12 12 12 12 12 12 12 12 12 12 12 12 12 12 13 12 12 12 12 
12 12 12 12 12 12 12 12 12 12 12 12 12 12 12 12 12 12 12 12 12 12 12 12 12 12 12 12 12 12 12 12 12 12 12 12 12 12 12 12 12 12 12 12 12 12 12 12 12 12 