46 46 46 46 46 46 46 46 46 46 46 46 46 46 46 46 46 46 46 46 46 46 46 46 46 46 46 46 46 46 46 46 46 46 46 46 46 46 46 46 46 46 46 46 46 46 46 46 46 46 
46 46 46 46 46 46 46 46 46 46 46 46 46 46 46 46 46 46 46 46 46 46 46 46 46 46 46 46 46 46 46 46 46 46 46 46 46 46 46 46 46 46 46 46 46 46 46 46 46 46 
46 46 46 46 46 46 46 46 46 46 46 46 46 46 46 46 46 46 46 46 46 46 46 46 46 46 46 46 46 46 46 46 46 46 46 46 46 46 46 46 46 46 46 46 46 46 46 46 46 46 
46 46 46 46 46 46 46 46 46 46 46 46 46 46 46 46 46 46 46 46 46 46 46 46 46 46 46 46 46 46 46 46 46 46 46 46 46 46 46 46 46 46 46 46 46 46 46 46 46 46  
46 46 46 46 46 46 46 46 46 46 46 46 46 46 46 46 46 46 46 46 46 46 46 46 46 46 46 46 46 46 46 46 46 46 46 46 46 46 46 46 46 46 46 46 46 46 46 46 46 46 
46 46 46 46 46 46 46 46 46 46 46 46 46 46 46 46 46 46 46 46 46 46 46 46 46 46 46 46 46 46 46 46 46 46 46 46 46 46 46 46 46 46 46 46 46 46 46 46 46 46  
46 46 46 46 46 46 46 46 46 46 46 46 46 46 46 46 46 46 46 46 46 46 46 46 46 46 46 46 46 46 46 46 46 46 46 46 46 46 46 46 46 46 46 46 46 46 46 46 46 46 
46 46 46 46 46 46 46 46 46 41 40 40 40 40 40 41 46 46 46 41 46 46 46 46 46 46 46 46 46 46 46 46 41 46 46 46 46 46 46 46 46 46 46 46 46 46 46 46 46 46
46 46 46 46 46 46 46 46 46 41 40 46 46 46 40 41 41 41 41 41 46 46 46 46 46 46 46 41 41 41 41 41 41 41 46 45 45 45 45 45 45 46 46 46 46 46 46 46 46 46
46 46 46 46 46 46 46 46 46 41 40 46 46 46 40 41 41 41 41 41 46 46 46 46 46 46 46 41 41 41 41 41 41 41 46 45 45 45 45 45 45 46 46 46 46 46 46 46 46 46
46 46 46 46 46 46 46 46 46 41 40 46 46 46 40 41 41 41 41 41 46 46 46 46 46 46 46 41 41 41 41 41 41 41 46 45 45 45 45 45 45 46 46 46 46 46 46 46 46 46
46 46 46 46 46 46 46 46 46 41 40 46 46 46 40 41 41 41 41 41 46 46 46 46 46 46 46 41 41 41 41 41 41 41 46 45 45 45 45 45 45 46 46 46 46 46 46 46 46 46
46 46 46 46 46 46 46 46 46 41 40 40 46 40 40 41 41 41 41 41 46 46 46 46 46 46 46 46 46 46 46 46 46 46 46 46 46 46 46 46 46 46 46 46 46 46 46 46 46 46
46 46 46 46 46 46 46 46 46 41 41 41 46 41 41 41 41 41 41 41 41 41 46 46 46 41 41 41 41 41 41 41 41 41 41 41 41 46 46 46 46 46 46 46 46 46 46 46 46 46
46 46 46 46 46 46 46 46 46 46 41 41 46 41 41 41 41 41 41 41 41 41 46 46 46 41 41 41 41 41 41 41 41 41 41 41 41 46 46 46 46 46 46 46 46 46 46 46 46 46 
46 46 46 46 46 46 46 46 46 46 41 41 46 41 41 41 41 41 41 41 41 41 46 46 46 41 41 41 41 41 41 41 41 41 41 41 41 46 46 46 46 46 46 46 46 46 46 46 46 46 
46 46 46 46 46 46 46 46 46 46 41 41 46 41 41 41 41 41 41 41 41 41 46 46 46 46 46 46 41 41 41 41 41 41 41 41 41 46 46 46 46 46 46 46 46 46 46 46 46 46 
46 46 46 46 46 46 46 46 46 41 41 41 46 41 41 41 41 41 41 41 41 41 46 46 46 41 41 41 41 41 41 41 41 41 41 46 46 46 46 46 46 46 46 46 46 46 46 46 46 46 
46 46 46 46 46 46 46 46 41 41 46 46 46 41 41 41 41 41 41 41 41 41 46 46 46 41 41 41 41 41 41 41 41 41 41 46 46 46 46 46 46 46 46 46 46 46 46 46 46 46 
46 46 46 46 46 46 46 46 41 41 46 41 41 41 41 41 41 41 41 41 41 46 46 46 46 46 41 41 41 41 41 41 41 41 41 46 46 46 46 46 46 46 46 46 46 46 46 46 46 46 
46 46 46 46 46 46 46 46 41 41 46 41 41 46 46 46 46 46 46 46 46 46 46 46 46 46 46 46 46 46 41 41 41 46 46 46 46 46 46 41 46 46 46 46 46 46 46 46 46 46 
46 46 46 46 46 46 46 46 41 41 46 41 41 46 46 46 46 46 46 46 46 46 46 46 46 46 46 46 46 46 46 46 46 46 46 46 46 46 46 46 46 46 46 46 46 46 46 46 46 46 
46 46 46 46 46 46 46 46 41 41 46 41 41 46 46 46 46 46 46 46 46 46 46 46 46 46 46 46 46 46 41 41 41 46 46 46 46 46 46 46 46 46 46 46 46 46 46 46 46 46 
46 46 46 46 46 46 46 46 46 41 46 41 41 46 41 41 41 41 41 41 41 46 46 46 46 46 41 41 41 41 41 41 41 41 41 46 46 46 46 46 46 46 46 46 46 46 46 46 46 46 
46 46 46 46 46 46 46 46 46 41 46 41 41 46 41 41 41 41 41 41 41 41 46 46 46 41 41 41 41 41 41 41 41 41 41 46 46 46 46 46 46 46 46 46 46 46 46 46 46 46 
46 46 46 46 46 46 46 46 46 41 46 41 41 46 46 41 41 41 41 41 41 41 46 46 46 41 41 41 41 41 41 41 41 41 41 46 46 46 46 46 46 46 46 46 46 46 46 46 46 46 
46 46 46 46 46 46 46 46 41 41 46 41 41 41 46 41 41 41 41 41 41 41 46 46 46 41 41 41 41 41 41 41 41 41 41 46 46 46 46 46 46 46 46 46 46 46 46 46 46 46 
46 46 46 46 46 46 46 46 41 41 46 41 41 41 46 41 41 41 41 41 41 41 46 46 46 41 41 46 41 41 41 41 41 41 41 46 46 46 46 46 46 46 46 46 46 46 46 46 46 46 
46 46 46 46 46 46 46 46 41 41 46 41 41 41 46 41 41 41 41 41 41 41 46 46 46 41 41 41 41 41 46 41 41 41 41 46 46 46 46 46 46 46 46 46 46 46 46 46 46 46 
46 46 46 46 46 46 46 46 41 41 46 46 46 46 46 46 41 41 41 41 41 41 46 46 46 41 41 41 41 41 46 41 41 41 41 46 46 46 46 46 46 46 46 46 46 46 46 46 46 46 
46 46 46 46 46 46 46 46 41 41 46 46 46 46 46 46 41 41 41 41 41 41 46 46 46 41 41 41 41 41 41 41 41 41 41 41 46 41 46 46 46 46 46 46 46 46 46 46 46 46 
46 46 46 46 46 46 46 46 46 41 46 46 46 46 46 46 41 41 41 41 41 41 46 46 46 41 41 41 41 41 41 41 41 41 41 46 46 46 46 46 46 46 46 46 46 46 46 46 46 46 
46 46 46 46 46 46 46 46 46 41 46 46 46 46 46 46 41 41 41 41 41 41 46 46 46 41 41 41 41 41 41 41 41 41 41 46 46 46 46 46 46 46 46 46 46 46 46 46 46 46 
46 46 46 46 46 46 46 46 46 41 46 46 46 46 46 46 41 41 41 41 41 41 46 46 46 41 41 41 41 41 41 41 41 41 41 46 46 46 46 46 46 46 46 46 46 46 46 46 46 46 
46 46 46 46 46 46 46 46 46 41 46 46 46 46 46 46 41 41 41 41 41 41 46 46 46 41 41 41 41 41 41 41 41 41 41 46 46 46 46 46 46 46 46 46 46 46 46 46 46 46 
46 46 46 46 46 46 46 46 46 41 41 41 41 41 41 41 41 41 41 41 41 41 46 46 46 41 41 41 41 41 41 41 41 41 41 46 46 46 46 46 46 46 46 46 46 46 46 46 46 46 
46 46 46 46 46 46 46 46 41 41 41 41 41 41 41 41 41 41 41 41 46 46 46 46 46 46 46 41 41 41 41 41 41 41 46 46 46 46 46 46 46 46 46 46 46 46 46 46 46 46 
46 46 46 46 46 46 46 46 41 41 41 41 41 41 41 41 41 41 41 46 46 46 46 46 46 46 46 46 41 41 46 41 41 46 46 46 46 46 46 46 46 46 46 46 46 46 46 46 46 46 
46 46 46 46 46 46 46 46 41 41 41 41 41 41 41 41 41 41 41 46 46 46 46 46 46 46 46 46 41 41 41 41 46 46 46 46 46 46 46 46 46 46 46 46 46 46 46 46 46 46 
46 46 46 46 46 46 46 46 41 41 46 41 41 41 41 41 41 41 41 46 46 46 46 46 46 46 46 46 46 41 41 41 46 46 46 46 46 41 46 46 46 46 46 46 46 46 46 46 46 46 
46 46 46 46 46 46 46 46 41 41 46 41 41 46 46 46 46 46 46 46 46 46 46 46 46 46 46 46 46 46 46 46 46 46 41 46 46 46 46 46 46 46 46 46 46 46 46 46 46 46 
46 46 46 46 46 46 46 46 41 41 46 46 46 46 41 46 46 46 46 46 46 46 46 46 46 46 46 46 46 46 46 46 46 46 46 46 46 46 46 46 46 46 46 46 46 46 46 46 46 46 
46 46 46 46 46 46 46 46 41 41 41 41 41 41 46 46 46 46 46 46 46 46 46 46 46 46 46 46 46 46 46 46 46 41 46 46 41 46 46 46 46 46 46 46 46 46 46 46 46 46 
46 46 46 46 46 46 46 46 46 46 46 46 46 46 46 46 46 46 46 46 46 46 46 46 46 46 46 46 46 46 46 46 46 46 46 46 46 46 46 46 46 46 46 46 46 46 46 46 46 46 
46 46 46 46 46 46 46 46 46 46 46 46 46 46 46 46 46 46 46 46 46 46 46 46 46 46 46 46 46 46 46 46 46 46 46 46 46 46 46 46 46 46 46 46 46 46 46 46 46 46 
46 46 46 46 46 46 46 46 46 46 46 46 46 46 46 46 46 46 46 46 46 46 46 46 46 46 46 46 46 46 46 46 46 46 46 46 46 46 46 46 46 46 46 46 46 46 46 46 46 46 
46 46 46 46 46 46 46 46 46 46 46 46 46 46 46 46 46 46 46 46 46 46 46 46 46 46 46 46 46 46 46 46 46 46 46 46 46 46 46 46 46 46 46 46 46 46 46 46 46 46 
46 46 46 46 46 46 46 46 46 46 46 46 46 46 46 46 46 46 46 46 46 46 46 46 46 46 46 46 46 46 46 46 46 46 46 46 46 46 46 46 46 46 46 46 46 46 46 46 46 46 
46 46 46 46 46 46 46 46 46 46 46 46 46 46 46 46 46 46 46 46 46 46 46 46 46 46 46 46 46 46 46 46 46 46 46 46 46 46 46 46 46 46 46 46 46 46 46 46 46 46 
46 46 46 46 46 46 46 46 46 46 46 46 46 46 46 46 46 46 46 46 46 46 46 46 46 46 46 46 46 46 46 46 46 46 46 46 46 46 46 46 46 46 46 46 46 46 46 46 46 46 