32 32 32 32 32 32 32 32 32 32 32 32 32 32 32 32 32 32 32 32 32 32 32 32 32 32 32 32 32 32 32 32 32 32 32 32 32 32 32 32 32 32 32 32 32 32 32 32 32 32 
32 32 32 32 32 32 32 32 32 32 32 32 32 32 41 32 32 32 32 32 32 32 32 32 32 32 32 32 32 32 32 32 32 32 32 32 32 32 32 32 32 32 32 32 32 32 32 32 32 32 
32 32 32 32 32 32 32 41 32 32 32 32 32 32 32 32 32 32 32 32 32 32 32 32 32 41 32 32 32 32 32 32 32 41 32 32 32 32 32 32 32 32 32 32 32 32 32 32 32 32 
32 32 32 32 41 32 32 32 32 32 32 41 32 32 32 32 32 32 41 32 32 32 32 32 32 32 32 41 32 32 32 32 32 32 32 32 32 32 32 32 32 41 32 32 32 32 32 32 32 32  
32 32 32 32 32 32 32 32 32 41 32 32 32 32 32 41 32 32 32 32 32 32 32 41 32 32 32 32 32 32 32 41 32 32 41 32 32 32 41 32 32 32 32 32 32 32 32 32 32 32 
32 32 32 32 32 32 32 32 32 32 32 32 32 32 32 32 32 32 32 32 32 41 32 32 32 32 32 32 32 41 32 32 32 32 32 32 41 32 32 32 32 32 32 41 32 32 32 32 32 32  
32 32 32 32 32 41 22 20 20 20 20 20 20 20 23 32 32 32 22 20 20 20 20 20 20 20 20 23 32 32 32 22 20 20 20 20 20 20 20 20 20 20 23 32 32 32 32 32 32 32 
32 32 32 32 32 32 18 10 22 22 22 22 22 10 19 20 20 20 21 10 10 10 11 10 10 10 10 19 20 20 20 21 10 10 35 33 33 33 33 33 33 36 17 32 32 41 32 32 32 32 
32 32 41 32 32 32 18 10 22 39 39 39 22 10 10 10 10 10 10 10 10 14 15 15 15 16 10 10 10 10 10 10 10 10 31 26 26 26 26 26 26 30 17 32 32 32 32 32 32 32
32 32 32 32 32 32 18 10 22 39 39 39 22 10 10 10 10 10 10 10 10 17 32 32 32 18 10 10 10 10 10 10 10 10 31 26 26 26 26 26 26 30 17 32 32 32 32 32 32 32 
32 32 32 41 32 32 18 10 22 39 39 39 22 10 10 10 10 10 10 10 10 17 32 32 32 18 11 10 10 10 10 10 10 10 31 26 26 26 26 26 26 30 17 32 41 32 32 32 32 32 
32 32 32 32 41 32 18 10 22 39 39 39 22 10 10 10 10 10 10 10 10 19 20 20 20 21 10 10 10 10 10 10 10 10 31 26 26 26 26 26 26 30 17 32 32 32 32 32 32 32 
32 32 32 32 32 32 18 10 22 22 39 22 22 10 10 10 10 10 10 10 11 10 35 33 36 10 10 10 10 10 10 10 10 10 37 28 28 29 26 27 28 38 17 41 32 32 32 32 32 32 
32 32 32 32 32 32 18 10 10 10 10 10 10 10 10 10 10 10 10 10 10 10 31 26 30 10 10 10 10 10 10 10 10 10 10 10 10 31 26 30 14 15 25 32 32 32 32 32 32 32 
32 32 32 32 41 32 18 10 10 10 10 10 10 10 10 10 10 10 10 10 10 10 31 26 30 10 10 10 10 10 10 10 10 10 10 10 10 31 26 30 17 32 32 32 32 41 32 32 32 32 
32 32 32 32 32 32 24 15 16 10 10 10 10 10 10 10 10 10 10 10 10 10 31 26 30 10 10 10 10 10 10 10 10 10 10 10 10 31 26 30 17 32 32 32 32 32 32 32 32 32 
32 32 32 32 32 32 32 32 18 10 10 10 10 10 10 10 10 10 10 10 10 10 31 26 30 10 10 10 10 10 10 10 10 10 10 10 10 31 26 30 17 32 32 32 32 32 41 32 32 32
32 32 41 32 32 32 32 22 21 10 10 10 10 10 10 10 10 10 10 10 10 10 31 26 30 10 10 10 10 10 10 10 10 10 10 35 33 34 26 30 17 32 32 41 32 32 32 32 32 32 
32 32 32 32 32 32 32 18 10 10 10 10 10 10 10 10 10 10 10 10 10 10 31 26 30 10 10 10 10 10 10 10 10 10 10 31 26 26 26 30 17 32 32 32 32 32 32 32 32 32 
32 32 32 41 32 32 32 18 10 10 10 10 10 10 10 10 10 10 10 10 10 10 31 26 30 10 10 10 10 10 10 10 10 10 10 31 26 27 28 38 17 32 41 32 32 32 32 32 32 32 
32 32 32 32 32 32 32 18 10 10 10 10 10 35 33 33 33 33 33 33 33 33 34 26 32 33 33 33 33 33 33 33 33 33 33 34 26 30 10 10 17 32 32 32 32 32 32 32 32 32 
32 32 32 32 32 41 32 18 10 10 10 10 11 31 26 26 26 26 26 26 26 26 26 26 26 26 26 26 26 26 26 26 26 26 26 26 26 30 10 14 25 32 32 32 32 32 32 32 32 32 
32 32 32 32 32 32 41 18 10 10 10 10 10 37 28 28 28 28 28 28 28 28 29 26 27 28 28 28 28 28 28 28 28 28 28 29 26 30 10 17 32 41 32 32 32 32 32 32 32 32 
32 32 32 32 32 32 32 24 16 10 10 10 10 10 10 10 10 10 10 10 10 10 31 26 30 10 10 10 10 10 10 10 10 10 10 31 26 30 10 17 32 32 32 32 41 32 32 32 32 32 
32 32 32 32 32 32 32 32 18 10 10 10 10 10 10 10 10 10 10 10 10 10 31 26 30 10 10 10 10 10 10 10 10 10 10 31 26 30 11 17 32 32 32 32 32 32 32 32 32 32 
32 32 32 32 32 41 32 22 21 10 10 10 10 10 10 10 10 10 10 10 10 10 31 26 30 10 10 10 10 10 10 10 10 10 10 31 26 30 10 17 32 32 32 41 32 32 32 32 32 32 
32 32 32 32 32 32 32 18 10 10 10 10 10 10 10 10 10 10 10 10 10 10 31 26 30 10 10 10 10 10 10 10 10 10 10 31 26 30 10 17 32 32 32 32 32 32 32 32 32 32 
32 32 32 41 32 32 32 18 10 10 10 10 10 10 10 10 10 10 10 10 10 10 31 26 30 10 10 10 10 10 10 10 10 10 10 31 26 30 10 17 32 41 32 32 32 32 32 32 32 32 
32 32 32 32 32 32 32 18 10 10 10 10 10 10 10 10 10 10 10 10 10 10 31 26 30 10 10 10 10 10 10 10 10 10 10 31 26 30 10 17 32 32 32 32 32 32 32 32 32 32 
32 32 32 32 32 32 41 18 10 10 10 10 10 10 10 10 10 10 10 10 10 10 31 26 30 10 10 10 10 10 10 10 10 10 10 37 28 38 10 17 32 32 32 32 41 32 32 32 32 32 
32 32 32 32 32 32 32 18 10 10 11 10 10 10 10 10 10 10 10 10 10 10 31 26 30 10 10 10 10 10 10 10 10 10 10 10 10 10 14 25 32 32 41 32 32 32 32 32 32 32 
32 32 32 32 32 32 32 24 16 10 10 10 10 10 10 10 10 10 10 10 10 10 31 26 30 10 10 10 10 10 10 10 10 10 10 10 10 10 17 32 32 32 32 32 32 32 32 32 32 32 
32 32 32 32 32 41 32 32 18 10 10 10 10 11 10 10 10 10 10 10 10 10 31 26 30 10 10 10 10 10 10 10 10 10 10 10 10 10 17 32 32 32 32 32 32 32 41 32 32 32 
32 32 32 32 32 32 32 32 18 11 10 10 10 10 10 10 10 10 10 10 10 10 31 26 30 10 10 10 10 10 10 10 10 10 10 10 10 11 17 32 32 41 32 32 32 32 32 32 32 32 
32 32 32 32 32 32 32 32 18 10 10 10 10 10 10 10 10 10 10 10 10 10 31 26 30 10 10 10 10 10 10 10 10 10 10 10 10 10 17 32 32 32 32 32 32 32 32 32 32 32 
32 32 32 32 41 32 32 22 21 10 10 10 10 10 10 10 10 10 10 10 10 10 37 28 38 10 10 10 10 10 10 10 10 10 10 11 10 10 19 23 32 32 32 32 32 32 32 32 32 32 
32 32 32 32 32 32 32 18 10 10 10 10 10 10 10 10 10 10 10 10 10 10 10 10 10 10 10 10 10 10 10 10 10 10 10 10 10 10 10 19 23 32 32 32 41 32 32 32 32 32 
32 32 32 32 32 32 41 18 10 10 10 10 10 10 10 10 10 10 10 10 10 10 10 10 10 10 10 10 10 10 10 10 10 10 10 10 10 10 10 10 17 32 32 32 32 32 32 32 32 32 
32 32 32 32 32 32 32 18 10 10 10 10 10 10 10 10 10 10 10 11 10 10 10 10 10 11 10 10 10 10 10 10 10 10 10 10 10 11 10 10 17 32 41 32 32 32 32 32 32 32 
32 32 32 32 32 32 32 18 10 10 10 10 10 10 10 10 10 10 10 10 11 10 10 10 10 10 10 10 10 10 10 10 10 10 10 10 10 10 10 10 17 32 32 32 32 32 32 32 32 32 
32 32 41 32 32 32 32 18 10 10 10 10 10 10 10 10 10 10 10 10 10 10 10 10 10 10 10 10 10 10 10 10 10 10 10 10 10 10 10 10 17 32 32 32 32 41 32 32 32 32 
32 32 32 32 32 32 32 18 10 10 10 10 10 10 10 14 15 15 16 10 10 10 10 10 11 10 10 14 15 15 16 10 10 10 10 10 10 10 11 10 17 32 32 32 32 32 32 41 32 32 
32 32 32 32 32 32 32 18 10 10 10 10 10 10 14 25 32 32 24 16 10 10 10 10 10 10 14 25 32 32 18 10 10 10 10 10 10 10 10 10 17 32 32 32 32 32 32 32 32 32 
32 32 32 32 41 32 32 24 15 15 15 15 15 15 25 32 32 32 32 24 15 15 15 15 15 15 25 32 41 32 24 16 10 11 10 10 10 10 14 15 25 32 41 32 32 32 32 32 32 32 
32 32 32 32 32 32 32 32 32 32 32 32 32 32 32 32 32 32 41 32 32 32 32 32 32 32 32 32 32 32 32 24 15 15 15 15 15 15 25 32 32 32 32 32 32 32 41 32 32 32 
32 32 32 32 32 32 32 32 32 32 32 41 32 32 32 32 41 32 32 32 32 32 32 32 32 32 32 32 32 32 32 32 32 32 32 32 41 32 32 32 32 32 32 41 32 32 32 32 32 32 
32 32 32 32 32 32 41 32 32 32 32 32 32 32 32 32 32 32 32 32 32 32 32 32 41 32 32 32 32 41 32 32 32 32 32 32 32 32 32 32 32 32 32 32 32 32 32 32 32 32 
32 32 32 32 32 32 32 32 32 32 32 32 32 32 41 32 32 32 32 32 41 32 32 32 32 32 32 32 32 32 32 32 41 32 32 32 32 32 32 41 32 32 32 32 32 32 32 32 32 32 
32 32 32 32 32 32 32 32 32 32 32 32 32 32 32 32 32 32 32 32 32 32 32 32 32 32 32 41 32 32 32 32 32 32 32 32 32 32 32 32 32 32 32 32 32 41 32 32 32 32 
32 32 32 32 32 32 32 32 32 32 32 32 32 32 32 32 32 32 32 32 32 32 32 32 32 32 32 32 32 32 32 32 32 32 32 32 32 32 32 32 32 32 32 32 32 32 32 32 32 32 